40 11
        ################################
        #.....k........................#
        #............,.+.x.............#.
        #....................k.........#
        #....s.........................#
        #..............@.......s.......#
        #..............................#
        #.....k........................#
        #.......................k......#
        #..............................#
        ################################